################################################################
#        #        #                                            #
#  ####  #  #######  ############################  ##########  #
#     #     #        #     #     #              #     #        #
####  #  ####  #######  #  #  #  #  ##########  ####  #  #######
#     #  #     #        #     #  #        #  #  #     #     #  #
#  ####  #  ####  ###################  #######  ##########  ####
#  #     #  #  #  #              #  #  #     #        #  #     #
#  #######  ####  #  ##########  #  #  #  #  ####  #  #######  #
#        #  #     #     #     #  #  #     #     #  #           #
#  ####  #  #  #######  ####  #  #############  #  #############
#  #     #  #        #     #  #              #  #           #  #
#  #  ####  #############  #  #############  #  ####  ####  ####
#  #  #                    #              #  #     #  #  #     #
#  #  #  ######################  #######  ## ####  #  #  ####  #
#  #        #     #                    #  #     #  #     #     #
#  #######  #  #  #  ####  #######  #######  #  #  ####  #  ####
#  #        #  #  #     #        #  #        #  #  #  #  #     #
#  #  #######  #  ####  #  ##########  ##########  #  #  ####  #
#  #  #        #     #  #     #     #           #  #     #  #  #
#  #  #  #############  ####  #  #############  #  ##########  #
#  #                       #  #     #  #  #     #        #  #  #
#  #  ############################  #######  ##########  ####  #
#  #        #     #  #        #  #  #  #              #  #     #
##########  #  #  #  #  ####  ####  ####  ####  #######  #  ####
#     #     #  #  #  #  #  #        #  #  #     #     #  #     #
#  ####  ####  #  #  #  ################  #  ####  #  #  #######
#           #  #  #  #                 #  #  #     #  #        #
##########  ####  #  ################  #  #  ################  #
#A                #                 #     #              #    B#
################################################################
